,region,Year,Born,Died,Diff,Born_,Died_,Diff_
0,Белгородская область,1970,15525,11865,3660,"12,3","9,4","2,9"
1,Белгородская область,1980,18872,16552,2320,"14,4","12,6","1,8"
2,Белгородская область,1990,18035,17910,125,"12,9","12,9",-
3,Белгородская область,1995,13696,21642,-7946,"9,4","14,8","-5,4"
4,Белгородская область,2000,12101,23291,-11190,8,"15,5","-7,5"
5,Белгородская область,2005,13486,24168,-10682,"8,9",16,"-7,1"
6,Белгородская область,2006,14382,23082,-8700,"9,5","15,3","-5,8"
7,Белгородская область,2007,15676,22417,-6741,"10,3","14,8","-4,5"
8,Белгородская область,2008,16790,22422,-5632,11,"14,7","-3,7"
9,Белгородская область,2009,16845,22011,-5166,11,"14,4","-3,4"
10,Белгородская область,2010,16635,22027,-5392,"10,9","14,4","-3,5"
11,Брянская область,1970,22409,13731,8678,"14,2","8,7","5,5"
12,Брянская область,1980,22098,18418,3680,"14,8","12,3","2,5"
13,Брянская область,1990,19102,18837,265,13,"12,9","0,1"
14,Брянская область,1995,13613,23481,-9868,"9,3",16,"-6,7"
15,Брянская область,2000,11111,25699,-14588,"7,8","18,2","-10,4"
16,Брянская область,2005,12009,26495,-14486,9,"19,8","-10,8"
17,Брянская область,2006,12092,24669,-12577,"9,1","18,6","-9,5"
18,Брянская область,2007,13349,23411,-10062,"10,2","17,8","-7,6"
19,Брянская область,2008,14259,23111,-8852,"10,9","17,7","-6,8"
20,Брянская область,2009,14401,21964,-7563,"11,1","16,9","-5,8"
21,Брянская область,2010,13727,21775,-8048,"10,7",17,"-6,3"
22,Владимирская область,1970,20425,14082,6343,"13,5","9,3","4,2"
23,Владимирская область,1980,22918,18043,4875,"14,4","11,4",3
24,Владимирская область,1990,20065,20674,-609,"12,1","12,5","-0,4"
25,Владимирская область,1995,12539,27033,-14494,"7,7","16,6","-8,9"
26,Владимирская область,2000,11918,29974,-18056,"7,6","19,1","-11,5"
27,Владимирская область,2005,13640,30074,-16434,"9,2","20,3","-11,1"
28,Владимирская область,2006,13914,28344,-14430,"9,5","19,3","-9,8"
29,Владимирская область,2007,14785,27207,-12422,"10,2","18,7","-8,5"
30,Владимирская область,2008,15569,27119,-11550,"10,8","18,8",-8
31,Владимирская область,2009,15551,26407,-10856,"10,8","18,4","-7,6"
32,Владимирская область,2010,15542,26082,-10540,"10,7",18,"-7,3"
33,Воронежская область,1970,31270,23448,7822,"12,4","9,3","3,1"
34,Воронежская область,1980,32834,31888,946,"13,3","12,9","0,4"
35,Воронежская область,1990,28517,34418,-5901,"11,5","13,9","-2,4"
36,Воронежская область,1995,20704,41585,-20881,"8,3","16,7","-8,4"
37,Воронежская область,2000,18519,43639,-25120,"7,6","17,9","-10,3"
38,Воронежская область,2005,19417,43639,-24222,"8,4","18,8","-10,4"
39,Воронежская область,2006,19257,41806,-22549,"8,4","18,1","-9,7"
40,Воронежская область,2007,20670,40561,-19891,9,"17,7","-8,7"
41,Воронежская область,2008,22361,40316,-17955,"9,8","17,7","-7,9"
42,Воронежская область,2009,23559,38581,-15022,"10,4",17,"-6,6"
43,Воронежская область,2010,23804,39767,-15963,"10,2",17,"-6,8"
44,Ивановская область,1970,16610,13142,3468,"12,7","10,1","2,6"
45,Ивановская область,1980,17895,16763,1132,"13,8",13,"0,8"
46,Ивановская область,1990,14952,18084,-3132,"11,6",14,"-2,4"
47,Ивановская область,1995,9236,23273,-14037,"7,4","18,6","-11,2"
48,Ивановская область,2000,8592,24651,-16059,"7,2","20,8","-13,6"
49,Ивановская область,2005,9639,24418,-14779,"8,7",22,"-13,3"
50,Ивановская область,2006,9820,21841,-12021,9,20,-11
51,Ивановская область,2007,10658,20372,-9714,"9,8","18,8",-9
52,Ивановская область,2008,11138,20769,-9631,"10,3","19,3",-9
53,Ивановская область,2009,11390,19887,-8497,"10,6","18,6",-8
54,Ивановская область,2010,11078,19604,-8526,"10,4","18,4",-8
55,Калужская область,1970,12766,9547,3219,"12,8","9,6","3,2"
56,Калужская область,1980,13971,12605,1366,"13,8","12,4","1,4"
57,Калужская область,1990,12839,13373,-534,12,"12,5","-0,5"
58,Калужская область,1995,8643,17986,-9343,"7,9","16,5","-8,6"
59,Калужская область,2000,7861,19254,-11393,"7,4","18,1","-10,7"
60,Калужская область,2005,9015,19561,-10546,"8,9","19,2","-10,3"
61,Калужская область,2006,9264,17853,-8589,"9,2","17,6","-8,4"
62,Калужская область,2007,10099,17377,-7278,10,"17,3","-7,3"
63,Калужская область,2008,10491,17374,-6883,"10,4","17,3","-6,9"
64,Калужская область,2009,10537,16762,-6225,"10,5","16,7","-6,2"
65,Калужская область,2010,11131,16730,-5599,11,"16,5","-5,5"
66,Костромская область,1970,10236,8929,1307,"11,9","10,4","1,5"
67,Костромская область,1980,11742,10770,972,"14,7","13,5","1,2"
68,Костромская область,1990,10236,10871,-635,"12,7","13,5","-0,8"
69,Костромская область,1995,6383,13685,-7302,"8,1","17,3","-9,2"
70,Костромская область,2000,6167,14301,-8134,"8,1","18,9","-10,8"
71,Костромская область,2005,6947,15004,-8057,"9,7",21,"-11,3"
72,Костромская область,2006,7070,13348,-6278,10,"18,9","-8,9"
73,Костромская область,2007,7469,12434,-4965,"10,7","17,8","-7,1"
74,Костромская область,2008,7839,12537,-4698,"11,3",18,"-6,7"
75,Костромская область,2009,8155,11900,-3745,"11,8","17,2","-5,4"
76,Костромская область,2010,8104,11861,-3757,"12,1","17,7","-5,6"
77,Курская область,1970,18234,14551,3683,"12,4","9,9","2,5"
78,Курская область,1980,18281,18753,-472,"13,2","13,6","-0,4"
79,Курская область,1990,15828,18560,-2732,"11,9","13,9",-2
80,Курская область,1995,11472,22464,-10992,"8,6","16,9","-8,3"
81,Курская область,2000,10451,23726,-13275,"8,2","18,6","-10,4"
82,Курская область,2005,10263,23453,-13190,"8,6","19,7","-11,1"
83,Курская область,2006,10575,22440,-11865,9,"19,1","-10,1"
84,Курская область,2007,11754,21039,-9285,"10,1",18,"-7,9"
85,Курская область,2008,12435,21240,-8805,"10,7","18,3","-7,6"
86,Курская область,2009,12462,20236,-7774,"10,8","17,6","-6,8"
87,Курская область,2010,12587,19852,-7265,"11,2","17,6","-6,4"
88,Липецкая область,1970,16792,10715,6077,"13,7","8,7",5
89,Липецкая область,1980,16119,14340,1779,"13,2","11,7","1,5"
90,Липецкая область,1990,14932,15835,-903,"12,1","12,8","-0,7"
91,Липецкая область,1995,10468,20150,-9682,"8,4","16,2","-7,8"
92,Липецкая область,2000,9602,20352,-10750,"7,8","16,5","-8,7"
93,Липецкая область,2005,11024,21216,-10192,"9,3","17,9","-8,6"
94,Липецкая область,2006,11290,20505,-9215,"9,6","17,4","-7,8"
95,Липецкая область,2007,11989,19961,-7972,"10,2",17,"-6,8"
96,Липецкая область,2008,12585,19971,-7386,"10,8","17,1","-6,3"
97,Липецкая область,2009,12654,19145,-6491,"10,9","16,5","-5,6"
98,Липецкая область,2010,12803,19582,-6779,"10,9","16,7","-5,8"
99,Московская область,1970,74536,48837,25699,"12,9","8,4","4,5"
100,Московская область,1980,81756,69550,12206,13,11,2
101,Московская область,1990,68374,81592,-13218,"10,2","12,2",-2
102,Московская область,1995,47507,116126,-68619,"7,1","17,4","-10,3"
103,Московская область,2000,47660,112519,-64859,"7,2",17,"-9,8"
104,Московская область,2005,59479,115757,-56278,9,"17,5","-8,5"
105,Московская область,2006,60509,112935,-52426,"9,1",17,"-7,9"
106,Московская область,2007,63785,110601,-46816,"9,6","16,6",-7
107,Московская область,2008,70322,111181,-40859,"10,5","16,6","-6,1"
108,Московская область,2009,74137,107079,-32942,11,"15,9","-4,9"
109,Московская область,2010,76881,108957,-32076,"10,9","15,4","-4,5"
110,Орловская область,1970,11274,9036,2238,"12,1","9,7","2,4"
111,Орловская область,1980,11682,11248,434,"13,2","12,7","0,5"
112,Орловская область,1990,10985,11699,-714,"12,3",13,"-0,7"
113,Орловская область,1995,7957,14663,-6706,"8,8","16,2","-7,4"
114,Орловская область,2000,6931,15628,-8697,"7,9","17,7","-9,8"
115,Орловская область,2005,7232,15585,-8353,"8,6","18,6",-10
116,Орловская область,2006,7492,14869,-7377,9,"17,9","-8,9"
117,Орловская область,2007,7926,14414,-6488,"9,6","17,5","-7,9"
118,Орловская область,2008,8353,14107,-5754,"10,2","17,2",-7
119,Орловская область,2009,8447,13498,-5051,"10,4","16,6","-6,2"
120,Орловская область,2010,8687,13724,-5037,11,"17,4","-6,4"
121,Рязанская область,1970,17528,13973,3555,"12,4","9,9","2,5"
122,Рязанская область,1980,17027,17585,-558,"12,6",13,"-0,4"
123,Рязанская область,1990,15635,18865,-3230,"11,6",14,"-2,4"
124,Рязанская область,1995,10345,23819,-13474,"7,8",18,"-10,2"
125,Рязанская область,2000,8876,24420,-15544,7,"19,3","-12,3"
126,Рязанская область,2005,10037,24082,-14045,"8,4","20,3","-11,9"
127,Рязанская область,2006,10047,22660,-12613,"8,5","19,2","-10,7"
128,Рязанская область,2007,11021,22209,-11188,"9,4",19,"-9,6"
129,Рязанская область,2008,11702,21545,-9843,"10,1","18,6","-8,5"
130,Рязанская область,2009,11643,20573,-8930,"10,1","17,8","-7,7"
131,Рязанская область,2010,11844,20964,-9120,"10,2","18,1","-7,9"
132,Смоленская область,1970,13305,11930,1375,"12,1","10,8","1,3"
133,Смоленская область,1980,15956,14759,1197,"14,1","13,1",1
134,Смоленская область,1990,13741,15362,-1621,"11,9","13,3","-1,4"
135,Смоленская область,1995,9378,19875,-10497,"8,1","17,2","-9,1"
136,Смоленская область,2000,7651,21784,-14133,7,20,-13
137,Смоленская область,2005,8717,21850,-13133,"8,6","21,6",-13
138,Смоленская область,2006,8835,20779,-11944,"8,8","20,8",-12
139,Смоленская область,2007,9451,19403,-9952,"9,6","19,6",-10
140,Смоленская область,2008,9931,19320,-9389,"10,1","19,7","-9,6"
141,Смоленская область,2009,10486,18660,-8174,"10,8","19,2","-8,4"
142,Смоленская область,2010,10307,18137,-7830,"10,4","18,4",-8
143,Тамбовская область,1970,18938,15650,3288,"12,6","10,4","2,2"
144,Тамбовская область,1980,17473,19460,-1987,"12,8","14,2","-1,4"
145,Тамбовская область,1990,15396,19643,-4247,"11,7","14,9","-3,2"
146,Тамбовская область,1995,10979,22676,-11697,"8,5","17,5",-9
147,Тамбовская область,2000,9719,23229,-13510,8,19,-11
148,Тамбовская область,2005,9636,22050,-12414,"8,5","19,4","-10,9"
149,Тамбовская область,2006,9217,20554,-11337,"8,2","18,3","-10,1"
150,Тамбовская область,2007,9911,19537,-9626,"8,9","17,6","-8,7"
151,Тамбовская область,2008,10169,19578,-9409,"9,2","17,8","-8,6"
152,Тамбовская область,2009,10146,18887,-8741,"9,3","17,3",-8
153,Тамбовская область,2010,10350,19198,-8848,"9,5","17,5",-8
154,Тверская область,1970,18813,20468,-1655,11,12,-1
155,Тверская область,1980,20841,24703,-3862,"12,7",15,"-2,3"
156,Тверская область,1990,19220,24808,-5588,"11,5","14,9","-3,4"
157,Тверская область,1995,12366,32108,-19742,"7,6","19,9","-12,3"
158,Тверская область,2000,11546,33126,-21580,"7,5","21,6","-14,1"
159,Тверская область,2005,13099,32768,-19669,"9,3","23,1","-13,8"
160,Тверская область,2006,13325,30542,-17217,"9,5","21,8","-12,3"
161,Тверская область,2007,14133,28529,-14396,"10,2","20,6","-10,4"
162,Тверская область,2008,14747,28412,-13665,"10,7","20,7",-10
163,Тверская область,2009,15084,27238,-12154,"11,1",20,"-8,9"
164,Тверская область,2010,14864,27333,-12469,11,"20,1","-9,1"
165,Тульская область,1970,23542,17544,5998,"12,1",9,"3,1"
166,Тульская область,1980,23077,24067,-990,"12,2","12,7","-0,5"
167,Тульская область,1990,18883,26836,-7953,"10,2","14,5","-4,3"
168,Тульская область,1995,13282,35248,-21966,"7,3","19,4","-12,1"
169,Тульская область,2000,11845,36403,-24558,"6,8",21,"-14,2"
170,Тульская область,2005,12609,35366,-22757,"7,8",22,"-14,2"
171,Тульская область,2006,12660,33263,-20603,8,"20,9","-12,9"
172,Тульская область,2007,13169,32102,-18933,"8,4","20,4",-12
173,Тульская область,2008,14112,31854,-17742,9,"20,4","-11,4"
174,Тульская область,2009,14751,29964,-15213,"9,5","19,4","-9,9"
175,Тульская область,2010,14723,30049,-15326,"9,5","19,3","-9,8"
176,Ярославская область,1970,17723,14577,3146,"12,7","10,4","2,3"
177,Ярославская область,1980,19656,18102,1554,"13,7","12,7",1
178,Ярославская область,1990,16599,19482,-2883,"11,3","13,2","-1,9"
179,Ярославская область,1995,10998,25221,-14223,"7,6","17,4","-9,8"
180,Ярославская область,2000,10171,25254,-15083,"7,3",18,"-10,7"
181,Ярославская область,2005,12291,26541,-14250,"9,2","19,9","-10,7"
182,Ярославская область,2006,12452,24182,-11730,"9,4","18,3","-8,9"
183,Ярославская область,2007,13085,23016,-9931,"9,9","17,5","-7,6"
184,Ярославская область,2008,13642,22796,-9154,"10,4","17,4",-7
185,Ярославская область,2009,14315,21665,-7350,"10,9","16,6","-5,7"
186,Ярославская область,2010,14345,21907,-7562,"11,3","17,2","-5,9"
187,Москва,1970,84491,67849,16642,"11,8","9,5","2,3"
188,Москва,1980,110859,95452,15407,"13,4","11,5","1,9"
189,Москва,1990,94462,114943,-20481,"10,6","12,8","-2,2"
190,Москва,1995,69168,146666,-77498,"7,5",16,"-8,5"
191,Москва,2000,73142,130950,-57808,"7,3","13,1","-5,8"
192,Москва,2005,92188,128634,-36446,"8,9","12,3","-3,4"
193,Москва,2006,94271,127278,-33007,9,"12,2","-3,2"
194,Москва,2007,100955,124099,-23144,"9,7","11,9","-2,2"
195,Москва,2008,107781,124188,-16407,"10,3","11,8","-1,5"
196,Москва,2009,116081,120077,-3996,11,"11,4","-0,4"
197,Москва,2010,122962,126032,-3070,"10,7","10,9","-0,2"
198,Республика Карелия,1970,11346,5333,6013,"15,9","7,5","8,4"
199,Республика Карелия,1980,12275,7374,4901,"16,6",10,"6,6"
200,Республика Карелия,1990,10553,8072,2481,"13,3","10,2","3,1"
201,Республика Карелия,1995,6729,12845,-6116,"8,8","16,7","-7,9"
202,Республика Карелия,2000,6374,12083,-5709,"8,7","16,5","-7,8"
203,Республика Карелия,2005,6952,12649,-5697,"9,9","18,1","-8,2"
204,Республика Карелия,2006,6938,11716,-4778,10,"16,8","-6,8"
205,Республика Карелия,2007,7319,11007,-3688,"10,6","15,9","-5,3"
206,Республика Карелия,2008,7682,11134,-3452,"11,1","16,2","-5,1"
207,Республика Карелия,2009,7884,10599,-2715,"11,5","15,5",-4
208,Республика Карелия,2010,7792,10451,-2659,"12,1","16,2","-4,1"
209,Республика Коми,1970,16462,6276,10186,17,"6,5","10,5"
210,Республика Коми,1980,20685,9169,11516,"18,2","8,1","10,1"
211,Республика Коми,1990,16930,9321,7609,"13,6","7,5","6,1"
212,Республика Коми,1995,11105,15057,-3952,"9,7","13,2","-3,5"
213,Республика Коми,2000,9906,13594,-3688,"9,4","12,9","-3,5"
214,Республика Коми,2005,10975,15074,-4099,"11,1","15,2","-4,1"
215,Республика Коми,2006,10872,13519,-2647,"11,1","13,8","-2,7"
216,Республика Коми,2007,11523,12304,-781,"11,9","12,7","-0,8"
217,Республика Коми,2008,11719,12270,-551,"12,2","12,7","-0,5"
218,Республика Коми,2009,11868,12182,-314,"12,4","12,8","-0,4"
219,Республика Коми,2010,11648,11819,-171,"12,9","13,1","-0,2"
220,Архангельская область,1970,21460,11848,9612,"15,3","8,5","6,8"
221,Архангельская область,1980,26427,15295,11132,"17,9","10,4","7,5"
222,Архангельская область,1990,21216,15455,5761,"13,5","9,8","3,7"
223,Архангельская область,1995,13275,22263,-8988,"8,9",15,"-6,1"
224,Архангельская область,2000,12150,22540,-10390,"8,8","16,3","-7,5"
225,Архангельская область,2005,13898,22027,-8129,"10,7",17,"-6,3"
226,Архангельская область,2006,14006,20269,-6263,"10,9","15,8","-4,9"
227,Архангельская область,2007,15153,18821,-3668,"11,9","14,7","-2,8"
228,Архангельская область,2008,15174,18496,-3322,12,"14,6","-2,6"
229,Архангельская область,2009,15499,18067,-2568,"12,3","14,4","-2,1"
230,Архангельская область,2010,15466,17975,-2509,"12,6","14,6",-2
231,Ненецкий автономный округ,1970,800,295,505,"20,4","7,5","12,9"
232,Ненецкий автономный округ,1980,941,387,554,"19,3","7,9","11,4"
233,Ненецкий автономный округ,1990,917,386,531,"17,7","7,4","10,3"
234,Ненецкий автономный округ,1995,602,570,32,"13,7",13,"0,7"
235,Ненецкий автономный округ,2000,541,531,10,"13,2","12,9","0,3"
236,Ненецкий автономный округ,2005,607,513,94,"14,5","12,2","2,3"
237,Ненецкий автономный округ,2006,587,540,47,14,"12,9","1,1"
238,Ненецкий автономный округ,2007,653,528,125,"15,6","12,6",3
239,Ненецкий автономный округ,2008,691,537,154,"16,4","12,8","3,6"
240,Ненецкий автономный округ,2009,695,495,200,"16,5","11,7","4,8"
241,Ненецкий автономный округ,2010,699,500,199,"16,4","11,7","4,7"
242,Вологодская область,1970,16558,13326,3232,"12,8","10,3","2,5"
243,Вологодская область,1980,21293,15830,5463,"16,2","12,1","4,1"
244,Вологодская область,1990,18202,16213,1989,"13,4",12,"1,4"
245,Вологодская область,1995,11651,21870,-10219,"8,7","16,4","-7,7"
246,Вологодская область,2000,11346,20728,-9382,"8,8",16,"-7,2"
247,Вологодская область,2005,13022,23379,-10357,"10,5","18,8","-8,3"
248,Вологодская область,2006,13458,21066,-7608,"10,9","17,1","-6,2"
249,Вологодская область,2007,14178,19509,-5331,"11,6","15,9","-4,3"
250,Вологодская область,2008,14616,19918,-5302,12,"16,3","-4,3"
251,Вологодская область,2009,15095,19742,-4647,"12,4","16,2","-3,8"
252,Вологодская область,2010,15102,20174,-5072,"12,5","16,8","-4,3"
253,Калининградская область,1970,11481,4556,6925,"15,6","6,2","9,4"
254,Калининградская область,1980,12471,7084,5387,"15,3","8,7","6,6"
255,Калининградская область,1990,11168,8673,2495,"12,6","9,8","2,8"
256,Калининградская область,1995,7946,12668,-4722,"8,5","13,5",-5
257,Калининградская область,2000,7573,14610,-7037,"7,9","15,2","-7,3"
258,Калининградская область,2005,8423,17086,-8663,"8,9","18,1","-9,2"
259,Калининградская область,2006,8754,15458,-6704,"9,3","16,5","-7,2"
260,Калининградская область,2007,10200,14425,-4225,"10,9","15,4","-4,5"
261,Калининградская область,2008,10589,14355,-3766,"11,3","15,3",-4
262,Калининградская область,2009,10823,13656,-2833,"11,5","14,6","-3,1"
263,Калининградская область,2010,10699,13317,-2618,"11,4","14,2","-2,8"
264,Ленинградская область,1970,16179,12635,3544,"11,9","9,3","2,6"
265,Ленинградская область,1980,21729,17992,3737,"14,1","11,7","2,4"
266,Ленинградская область,1990,18310,20873,-2563,11,"12,5","-1,5"
267,Ленинградская область,1995,12115,30543,-18428,"7,2","18,1","-10,9"
268,Ленинградская область,2000,11307,31588,-20281,"6,7","18,8","-12,1"
269,Ленинградская область,2005,12863,33426,-20563,"7,8","20,3","-12,5"
270,Ленинградская область,2006,12943,31608,-18665,"7,9","19,3","-11,4"
271,Ленинградская область,2007,13654,29733,-16079,"8,3","18,2","-9,9"
272,Ленинградская область,2008,14296,29327,-15031,"8,8",18,"-9,2"
273,Ленинградская область,2009,15023,27732,-12709,"9,2",17,"-7,8"
274,Ленинградская область,2010,15032,27097,-12065,"8,8","15,8",-7
275,Мурманская область,1970,12506,3925,8581,"15,5","4,9","10,6"
276,Мурманская область,1980,16012,6312,9700,"16,1","6,4","9,7"
277,Мурманская область,1990,13301,6900,6401,"11,2","5,8","5,4"
278,Мурманская область,1995,8596,12013,-3417,"8,2","11,4","-3,2"
279,Мурманская область,2000,8020,10805,-2785,"8,6","11,6",-3
280,Мурманская область,2005,8516,11672,-3156,"9,8","13,4","-3,6"
281,Мурманская область,2006,8455,10963,-2508,"9,8","12,7","-2,9"
282,Мурманская область,2007,8821,10011,-1190,"10,3","11,7","-1,4"
283,Мурманская область,2008,9100,10160,-1060,"10,7",12,"-1,3"
284,Мурманская область,2009,9074,10050,-976,"10,8",12,"-1,2"
285,Мурманская область,2010,9320,9513,-193,"11,7","11,9","-0,2"
286,Новгородская область,1970,8646,8193,453,12,"11,4","0,6"
287,Новгородская область,1980,10472,10332,140,"14,4","14,2","0,2"
288,Новгородская область,1990,9231,10628,-1397,"12,3","14,1","-1,8"
289,Новгородская область,1995,5875,14644,-8769,8,"19,9","-11,9"
290,Новгородская область,2000,5365,14382,-9017,"7,5","20,1","-12,6"
291,Новгородская область,2005,6239,15052,-8813,"9,3","22,5","-13,2"
292,Новгородская область,2006,6469,14226,-7757,"9,8","21,5","-11,7"
293,Новгородская область,2007,7009,13177,-6168,"10,7","20,1","-9,4"
294,Новгородская область,2008,6893,13562,-6669,"10,6","20,9","-10,3"
295,Новгородская область,2009,7178,13137,-5959,"11,2","20,4","-9,2"
296,Новгородская область,2010,7203,12751,-5548,"11,3","20,1","-8,8"
297,Псковская область,1970,10079,11445,-1366,"11,5","13,1","-1,6"
298,Псковская область,1980,11096,13289,-2193,"13,2","15,8","-2,6"
299,Псковская область,1990,10040,12730,-2690,"11,9","15,1","-3,2"
300,Псковская область,1995,6434,17347,-10913,"7,8","20,9","-13,1"
301,Псковская область,2000,5795,17524,-11729,"7,4","22,3","-14,9"
302,Псковская область,2005,6428,17920,-11492,"8,8","24,5","-15,7"
303,Псковская область,2006,6433,16721,-10288,"8,9","23,3","-14,4"
304,Псковская область,2007,6890,14796,-7906,"9,7","20,9","-11,2"
305,Псковская область,2008,7037,15174,-8137,10,"21,7","-11,7"
306,Псковская область,2009,7171,14502,-7331,"10,4","20,9","-10,5"
307,Псковская область,2010,7078,14322,-7244,"10,5","21,2","-10,7"
308,Санкт-Петербург,1970,51359,37279,14080,"12,7","9,2","3,5"
309,Санкт-Петербург,1980,63887,53839,10048,"13,7","11,6","2,1"
310,Санкт-Петербург,1990,54322,61534,-7212,"10,9","12,3","-1,4"
311,Санкт-Петербург,1995,33841,76723,-42882,7,"15,9","-8,9"
312,Санкт-Петербург,2000,31970,76396,-44426,"6,8","16,2","-9,4"
313,Санкт-Петербург,2005,39462,73371,-33909,"8,6",16,"-7,4"
314,Санкт-Петербург,2006,40079,70025,-29946,"8,8","15,3","-6,5"
315,Санкт-Петербург,2007,43275,67467,-24192,"9,5","14,8","-5,3"
316,Санкт-Петербург,2008,47455,66709,-19254,"10,4","14,6","-4,2"
317,Санкт-Петербург,2009,52097,64919,-12822,"11,3","14,1","-2,8"
318,Санкт-Петербург,2010,55560,65394,-9834,"11,5","13,5",-2
319,Адыгея,1970,5681,3307,2374,"14,7","8,6","6,1"
320,Адыгея,1980,6610,4828,1782,"16,2","11,8","4,4"
321,Адыгея,1990,6171,5375,796,"14,2","12,3","1,9"
322,Адыгея,1995,4798,6475,-1677,"10,7","14,4","-3,7"
323,Адыгея,2000,4071,6710,-2639,"9,1",15,"-5,9"
324,Адыгея,2005,4550,6726,-2176,"10,3","15,2","-4,9"
325,Адыгея,2006,4606,6686,-2080,"10,4","15,1","-4,7"
326,Адыгея,2007,5210,6454,-1244,"11,8","14,6","-2,8"
327,Адыгея,2008,5601,6558,-957,"12,7","14,8","-2,1"
328,Адыгея,2009,5513,6219,-706,"12,4",14,"-1,6"
329,Адыгея,2010,5688,6188,-500,"12,9","14,1","-1,2"
330,Республика Калмыкия,1970,4801,1661,3140,"17,9","6,2","11,7"
331,Республика Калмыкия,1980,7062,2735,4327,"23,8","9,2","14,6"
332,Республика Калмыкия,1990,6828,2669,4159,"20,9","8,2","12,7"
333,Республика Калмыкия,1995,4321,3359,962,"13,7","10,6","3,1"
334,Республика Калмыкия,2000,3473,3439,34,"11,3","11,2","0,1"
335,Республика Калмыкия,2005,3788,3350,438,"13,1","11,6","1,5"
336,Республика Калмыкия,2006,3820,3207,613,"13,3","11,1","2,2"
337,Республика Калмыкия,2007,4146,3141,1005,"14,5",11,"3,5"
338,Республика Калмыкия,2008,4354,2976,1378,"15,3","10,5","4,8"
339,Республика Калмыкия,2009,4270,3115,1155,"15,1",11,"4,1"
340,Республика Калмыкия,2010,4432,3191,1241,"15,3",11,"4,3"
341,Краснодарский край,1970,57787,38068,19719,14,"9,2","4,8"
342,Краснодарский край,1980,67704,55440,12264,"15,2","12,4","2,8"
343,Краснодарский край,1990,61663,62031,-368,"13,2","13,3","-0,1"
344,Краснодарский край,1995,50489,77000,-26511,10,"15,3","-5,3"
345,Краснодарский край,2000,45847,77971,-32124,"8,9","15,2","-6,3"
346,Краснодарский край,2005,52309,79757,-27448,"10,3","15,6","-5,3"
347,Краснодарский край,2006,53244,75334,-22090,"10,4","14,8","-4,4"
348,Краснодарский край,2007,57908,73744,-15836,"11,3","14,4","-3,1"
349,Краснодарский край,2008,62383,72945,-10562,"12,2","14,2",-2
350,Краснодарский край,2009,63730,70497,-6767,"12,4","13,7","-1,3"
351,Краснодарский край,2010,63624,70728,-7104,"12,2","13,6","-1,4"
352,Астраханская область,1970,12376,7358,5018,"14,2","8,5","5,7"
353,Астраханская область,1980,15001,9725,5276,"16,3","10,5","5,8"
354,Астраханская область,1990,15067,10412,4655,"15,1","10,4","4,7"
355,Астраханская область,1995,10362,13868,-3506,"10,2","13,6","-3,4"
356,Астраханская область,2000,10027,14466,-4439,"9,9","14,3","-4,4"
357,Астраханская область,2005,12121,15453,-3332,"12,2","15,5","-3,3"
358,Астраханская область,2006,12375,14654,-2279,"12,4","14,7","-2,3"
359,Астраханская область,2007,13437,14052,-615,"13,5","14,1","-0,6"
360,Астраханская область,2008,14203,13642,561,"14,2","13,6","0,6"
361,Астраханская область,2009,14279,13459,820,"14,2","13,4","0,8"
362,Астраханская область,2010,14307,13636,671,"14,2","13,5","0,7"
363,Волгоградская область,1970,33867,19568,14299,"14,5","8,4","6,1"
364,Волгоградская область,1980,37793,27095,10698,"15,2","10,9","4,3"
365,Волгоградская область,1990,34153,30771,3382,13,"11,7","1,3"
366,Волгоградская область,1995,24439,39523,-15084,9,"14,5","-5,5"
367,Волгоградская область,2000,22346,41614,-19268,"8,2","15,2",-7
368,Волгоградская область,2005,24949,41519,-16570,"9,4","15,7","-6,3"
369,Волгоградская область,2006,25869,40105,-14236,"9,8","15,3","-5,5"
370,Волгоградская область,2007,28038,38221,-10183,"10,7","14,6","-3,9"
371,Волгоградская область,2008,29438,37797,-8359,"11,3","14,5","-3,2"
372,Волгоградская область,2009,29507,37670,-8163,"11,4","14,5","-3,1"
373,Волгоградская область,2010,29427,38270,-8843,"11,3","14,6","-3,3"
374,Ростовская область,1970,51055,34132,16923,"13,3","8,9","4,4"
375,Ростовская область,1980,62209,48286,13923,"15,1","11,7","3,4"
376,Ростовская область,1990,54021,53992,29,"12,5","12,5",-
377,Ростовская область,1995,40676,70041,-29365,"9,1","15,6","-6,5"
378,Ростовская область,2000,35606,67555,-31949,8,"15,2","-7,2"
379,Ростовская область,2005,39613,68815,-29202,"9,2","15,9","-6,7"
380,Ростовская область,2006,40876,66634,-25758,"9,5","15,5",-6
381,Ростовская область,2007,43606,63835,-20229,"10,2",15,"-4,8"
382,Ростовская область,2008,45876,63827,-17951,"10,8",15,"-4,2"
383,Ростовская область,2009,46120,62296,-16176,"10,9","14,7","-3,8"
384,Ростовская область,2010,46607,62879,-16272,"10,9","14,7","-3,8"
385,Дагестан,1970,41381,9543,31838,"28,7","6,6","22,1"
386,Дагестан,1980,44088,11188,32900,"26,6","6,7","19,9"
387,Дагестан,1990,48209,11482,36727,"26,1","6,2","19,9"
388,Дагестан,1995,45680,15700,29980,"20,7","7,1","13,6"
389,Дагестан,2000,38229,16108,22121,"15,5","6,5",9
390,Дагестан,2005,40814,15585,25229,"15,5","5,9","9,6"
391,Дагестан,2006,40646,15939,24707,"15,3",6,"9,3"
392,Дагестан,2007,45470,15357,30113,17,"5,7","11,3"
393,Дагестан,2008,49465,15794,33671,"18,3","5,9","12,4"
394,Дагестан,2009,50416,16737,33679,"18,5","6,1","12,4"
395,Дагестан,2010,52057,17013,35044,"17,5","5,7","11,8"
396,Ингушетия,1970,22651,6075,16576,"21,1","5,7","15,4"
397,Ингушетия,1980,24291,7711,16580,"20,9","6,6","14,3"
398,Ингушетия,1990,31993,11039,20954,"24,1","8,3","15,8"
399,Ингушетия,1995,6889,1867,5022,"25,3","6,8","18,5"
400,Ингушетия,2000,8463,2117,6346,"21,5","5,4","16,1"
401,Ингушетия,2005,6777,1821,4956,14,"3,8","10,2"
402,Ингушетия,2006,7391,1830,5561,"15,1","3,7","11,4"
403,Ингушетия,2007,8284,1625,6659,"16,7","3,3","13,4"
404,Ингушетия,2008,9215,1561,7654,"18,3","3,1","15,2"
405,Ингушетия,2009,9572,1877,7695,"18,7","3,7",15
406,Ингушетия,2010,11178,1857,9321,"27,3","4,5","22,8"
407,Кабардино-Балкарская республика,1970,11683,3913,7770,"19,7","6,6","13,1"
408,Кабардино-Балкарская республика,1980,14098,5457,8641,"20,6",8,"12,6"
409,Кабардино-Балкарская республика,1990,15412,6573,8839,20,"8,5","11,5"
410,Кабардино-Балкарская республика,1995,10844,8236,2608,"13,1","9,9","3,2"
411,Кабардино-Балкарская республика,2000,9207,8792,415,"10,4",10,"0,4"
412,Кабардино-Балкарская республика,2005,8991,9034,-43,10,"10,1","-0,1"
413,Кабардино-Балкарская республика,2006,9308,8764,544,"10,4","9,8","0,6"
414,Кабардино-Балкарская республика,2007,11397,8441,2956,"12,8","9,5","3,3"
415,Кабардино-Балкарская республика,2008,12052,8095,3957,"13,5","9,1","4,4"
416,Кабардино-Балкарская республика,2009,12143,8406,3737,"13,6","9,4","4,2"
417,Кабардино-Балкарская республика,2010,12576,8080,4496,"14,6","9,4","5,2"
418,Кабардино-Балкарская республика,1970,6021,2153,3868,"17,4","6,2","11,2"
419,Кабардино-Балкарская республика,1980,7044,2794,4250,19,"7,5","11,5"
420,Кабардино-Балкарская республика,1990,7218,3496,3722,"17,1","8,3","8,8"
421,Кабардино-Балкарская республика,1995,5633,4501,1132,"12,9","10,3","2,6"
422,Кабардино-Балкарская республика,2000,4666,4961,-295,"10,6","11,3","-0,7"
423,Кабардино-Балкарская республика,2005,5194,5131,63,12,"11,9","0,1"
424,Кабардино-Балкарская республика,2006,5032,4924,108,"11,7","11,4","0,3"
425,Кабардино-Балкарская республика,2007,6066,4626,1440,"14,2","10,8","3,4"
426,Кабардино-Балкарская республика,2008,6364,4731,1633,"14,9","11,1","3,8"
427,Кабардино-Балкарская республика,2009,6200,4711,1489,"14,5",11,"3,5"
428,Кабардино-Балкарская республика,2010,6139,4737,1402,"12,8","9,9","2,9"
429,Северная Осетия - Алания,1970,9731,3964,5767,"17,5","7,1","10,4"
430,Северная Осетия - Алания,1980,10135,5821,4314,"16,9","9,7","7,2"
431,Северная Осетия - Алания,1990,10967,6166,4801,"16,9","9,5","7,4"
432,Северная Осетия - Алания,1995,8781,8574,207,13,"12,7","0,3"
433,Северная Осетия - Алания,2000,7179,8626,-1447,"10,3","12,3",-2
434,Северная Осетия - Алания,2005,7894,8654,-760,"11,2","12,3","-1,1"
435,Северная Осетия - Алания,2006,8308,8138,170,"11,8","11,6","0,2"
436,Северная Осетия - Алания,2007,9556,7806,1750,"13,6","11,1","2,5"
437,Северная Осетия - Алания,2008,9981,7975,2006,"14,2","11,4","2,8"
438,Северная Осетия - Алания,2009,10017,7987,2030,"14,3","11,4","2,9"
439,Северная Осетия - Алания,2010,10303,7748,2555,"14,5","10,9","3,6"
440,Чеченская республика,1970,22651,6075,16576,"21,1","5,7","15,4"
441,Чеченская республика,1980,24291,7711,16580,"20,9","6,6","14,3"
442,Чеченская республика,1990,31993,11039,20954,"24,1","8,3","15,8"
443,Чеченская республика,1995,...,...,...,...,...,...
444,Чеченская республика,2000,...,...,...,...,...,...
445,Чеченская республика,2005,28652,5857,22795,"24,9","5,1","19,8"
446,Чеченская республика,2006,27989,5889,22100,"23,9",5,"18,9"
447,Чеченская республика,2007,32449,5630,26819,"27,1","4,7","22,4"
448,Чеченская республика,2008,35897,5447,30450,"29,3","4,5","24,8"
449,Чеченская республика,2009,36523,6620,29903,"29,1","5,3","23,8"
450,Чеченская республика,2010,37753,7042,30711,30,"5,6","24,4"
451,Ставропольский край,1970,27987,17779,10208,"14,2",9,"5,2"
452,Ставропольский край,1980,35234,24806,10428,"15,9","11,2","4,7"
453,Ставропольский край,1990,36374,28590,7784,"14,8","11,6","3,2"
454,Ставропольский край,1995,28404,36022,-7618,"10,6","13,5","-2,9"
455,Ставропольский край,2000,24799,37304,-12505,9,"13,6","-4,6"
456,Ставропольский край,2005,27251,39070,-11819,10,"14,4","-4,4"
457,Ставропольский край,2006,27429,38439,-11010,"10,1","14,2","-4,1"
458,Ставропольский край,2007,30642,36167,-5525,"11,3","13,4","-2,1"
459,Ставропольский край,2008,33007,36252,-3245,"12,2","13,4","-1,2"
460,Ставропольский край,2009,32702,35631,-2929,"12,1","13,2","-1,1"
461,Ставропольский край,2010,33014,34512,-1498,"11,9","12,4","-0,5"
462,Башкортостан,1970,63498,28004,35494,"16,6","7,3","9,3"
463,Башкортостан,1980,67743,36067,31676,"17,6","9,4","8,2"
464,Башкортостан,1990,63899,38157,25742,"16,2","9,7","6,5"
465,Башкортостан,1995,45622,51734,-6112,"11,2","12,7","-1,5"
466,Башкортостан,2000,41642,53550,-11908,"10,1",13,"-2,9"
467,Башкортостан,2005,44094,57787,-13693,"10,8","14,2","-3,4"
468,Башкортостан,2006,45055,55319,-10264,"11,1","13,6","-2,5"
469,Башкортостан,2007,51453,55144,-3691,"12,7","13,6","-0,9"
470,Башкортостан,2008,54493,55568,-1075,"13,4","13,7","-0,3"
471,Башкортостан,2009,55587,53227,2360,"13,7","13,1","0,6"
472,Башкортостан,2010,57093,54457,2636,14,"13,4","0,6"
473,Марий Эл,1970,10505,6364,4141,"15,3","9,3",6
474,Марий Эл,1980,13169,8091,5078,"18,6","11,4","7,2"
475,Марий Эл,1990,11953,7775,4178,"15,8","10,3","5,5"
476,Марий Эл,1995,7337,9999,-2662,"9,7","13,2","-3,5"
477,Марий Эл,2000,6784,11040,-4256,"9,1","14,9","-5,8"
478,Марий Эл,2005,7475,12256,-4781,"10,5","17,2","-6,7"
479,Марий Эл,2006,7550,11286,-3736,"10,6","15,9","-5,3"
480,Марий Эл,2007,8306,10745,-2439,"11,8","15,2","-3,4"
481,Марий Эл,2008,8620,10699,-2079,"12,3","15,2","-2,9"
482,Марий Эл,2009,8896,10435,-1539,"12,7","14,9","-2,2"
483,Марий Эл,2010,8857,10572,-1715,"12,7","15,2","-2,5"
484,Республика Мордовия,1970,15423,9048,6375,15,"8,8","6,2"
485,Республика Мордовия,1980,14320,10287,4033,"14,6","10,5","4,1"
486,Республика Мордовия,1990,12910,11018,1892,"13,4","11,4",2
487,Республика Мордовия,1995,8589,13460,-4871,9,"14,1","-5,1"
488,Республика Мордовия,2000,7148,14838,-7690,"7,8","16,2","-8,4"
489,Республика Мордовия,2005,7394,14823,-7429,"8,6","17,2","-8,6"
490,Республика Мордовия,2006,7367,13981,-6614,"8,6","16,4","-7,8"
491,Республика Мордовия,2007,7728,13320,-5592,"9,2","15,8","-6,6"
492,Республика Мордовия,2008,8215,13167,-4952,"9,8","15,7","-5,9"
493,Республика Мордовия,2009,8103,13027,-4924,"9,8","15,7","-5,9"
494,Республика Мордовия,2010,7974,13106,-5132,"9,5","15,7","-6,2"
495,Татарстан,1970,47817,25622,22195,"15,2","8,1","7,1"
496,Татарстан,1980,54272,32758,21514,"15,8","9,5","6,3"
497,Татарстан,1990,56277,36219,20058,"15,4","9,9","5,5"
498,Татарстан,1995,39070,48592,-9522,"10,4","12,9","-2,5"
499,Татарстан,2000,35446,49723,-14277,"9,4","13,1","-3,7"
500,Татарстан,2005,36967,51841,-14874,"9,8","13,8",-4
501,Татарстан,2006,37303,49218,-11915,"9,9","13,1","-3,2"
502,Татарстан,2007,40892,48962,-8070,"10,9",13,"-2,1"
503,Татарстан,2008,44290,48952,-4662,"11,8",13,"-1,2"
504,Татарстан,2009,46605,47892,-1287,"12,4","12,7","-0,3"
505,Татарстан,2010,48791,49713,-922,"12,9","13,1","-0,2"
506,Удмуртская республика,1970,23286,13265,10021,"16,4","9,3","7,1"
507,Удмуртская республика,1980,27601,16862,10739,"18,3","11,2","7,1"
508,Удмуртская республика,1990,24345,15816,8529,"15,1","9,8","5,3"
509,Удмуртская республика,1995,15484,22445,-6961,"9,6","13,9","-4,3"
510,Удмуртская республика,2000,16256,21852,-5596,"10,2","13,7","-3,5"
511,Удмуртская республика,2005,17190,24006,-6816,"11,1","15,5","-4,4"
512,Удмуртская республика,2006,17480,22011,-4531,"11,3","14,3",-3
513,Удмуртская республика,2007,19667,21727,-2060,"12,8","14,2","-1,4"
514,Удмуртская республика,2008,20421,21436,-1015,"13,3",14,"-0,7"
515,Удмуртская республика,2009,21109,20227,882,"13,8","13,2","0,6"
516,Удмуртская республика,2010,21684,21100,584,"14,2","13,9","0,3"
517,Чувашия,1970,22465,10993,11472,"18,3","8,9","9,4"
518,Чувашия,1980,22612,13908,8704,"17,3","10,7","6,6"
519,Чувашия,1990,21116,13545,7571,"15,8","10,1","5,7"
520,Чувашия,1995,13842,17727,-3885,"10,3","13,2","-2,9"
521,Чувашия,2000,12363,18640,-6277,"9,3",14,"-4,7"
522,Чувашия,2005,13133,19682,-6549,"10,1","15,2","-5,1"
523,Чувашия,2006,13291,18900,-5609,"10,3","14,7","-4,4"
524,Чувашия,2007,14835,18642,-3807,"11,6","14,5","-2,9"
525,Чувашия,2008,14967,18436,-3469,"11,7","14,4","-2,7"
526,Чувашия,2009,16103,17492,-1389,"12,6","13,7","-1,1"
527,Чувашия,2010,16174,18186,-2012,"12,9","14,5","-1,6"
528,Пермский край,1970,46941,28007,18934,"15,6","9,3","6,3"
529,Пермский край,1980,48808,35913,12895,"16,3",12,"4,3"
530,Пермский край,1990,42183,33647,8536,"13,9","11,1","2,8"
531,Пермский край,1995,27727,47696,-19969,"9,4","16,1","-6,7"
532,Пермский край,2000,27701,46338,-18637,"9,7","16,2","-6,5"
533,Пермский край,2005,29974,49401,-19427,"10,9","17,9",-7
534,Пермский край,2006,30266,45104,-14838,11,"16,5","-5,5"
535,Пермский край,2007,32991,42718,-9727,"12,1","15,7","-3,6"
536,Пермский край,2008,35237,42162,-6925,13,"15,5","-2,5"
537,Пермский край,2009,36043,40609,-4566,"13,3",15,"-1,7"
538,Пермский край,2010,37304,40371,-3067,"14,1","15,3","-1,2"
539,Кировская область,1970,22032,18240,3792,"12,8","10,6","2,2"
540,Кировская область,1980,25837,21008,4829,"15,6","12,7","2,9"
541,Кировская область,1990,21493,19983,1510,13,"12,1","0,9"
542,Кировская область,1995,13290,26648,-13358,"8,2","16,5","-8,3"
543,Кировская область,2000,12587,25882,-13295,"8,1","16,8","-8,7"
544,Кировская область,2005,13541,27640,-14099,"9,3",19,"-9,7"
545,Кировская область,2006,13928,25347,-11419,"9,7","17,7",-8
546,Кировская область,2007,15006,23810,-8804,"10,6","16,8","-6,2"
547,Кировская область,2008,15906,24081,-8175,"11,3","17,1","-5,8"
548,Кировская область,2009,15897,23176,-7279,"11,4","16,6","-5,2"
549,Кировская область,2010,15803,22514,-6711,"11,8","16,8",-5
550,Нижегородская область,1970,48986,34451,14535,"13,2","9,3","3,9"
551,Нижегородская область,1980,49987,44958,5029,"13,5","12,1","1,4"
552,Нижегородская область,1990,42786,48667,-5881,"11,3","12,9","-1,6"
553,Нижегородская область,1995,29881,65518,-35637,8,"17,6","-9,6"
554,Нижегородская область,2000,27699,65310,-37611,"7,7","18,1","-10,4"
555,Нижегородская область,2005,30633,68731,-38098,"8,9",20,"-11,1"
556,Нижегородская область,2006,31048,64642,-33594,"9,1",19,"-9,9"
557,Нижегородская область,2007,33225,61768,-28543,"9,9","18,3","-8,4"
558,Нижегородская область,2008,35389,61029,-25640,"10,6","18,2","-7,6"
559,Нижегородская область,2009,36224,58197,-21973,"10,9","17,5","-6,6"
560,Нижегородская область,2010,36281,59241,-22960,"10,9","17,9",-7
561,Оренбургская область,1970,32045,16259,15786,"15,6","7,9","7,7"
562,Оренбургская область,1980,36909,20511,16398,"17,5","9,7","7,8"
563,Оренбургская область,1990,33311,20933,12378,"15,5","9,7","5,8"
564,Оренбургская область,1995,22833,30033,-7200,"10,3","13,6","-3,3"
565,Оренбургская область,2000,21475,31755,-10280,"9,7","14,4","-4,7"
566,Оренбургская область,2005,22460,33145,-10685,"10,5","15,5",-5
567,Оренбургская область,2006,23335,31583,-8248,"10,9","14,8","-3,9"
568,Оренбургская область,2007,25776,31000,-5224,"12,1","14,6","-2,5"
569,Оренбургская область,2008,26947,30904,-3957,"12,7","14,6","-1,9"
570,Оренбургская область,2009,28144,29215,-1071,"13,3","13,8","-0,5"
571,Оренбургская область,2010,28601,29572,-971,"14,1","14,5","-0,4"
572,Пензенская область,1970,21532,14019,7513,14,"9,1","4,9"
573,Пензенская область,1980,21759,17151,4608,"14,5","11,4","3,1"
574,Пензенская область,1990,18604,18431,173,12,"11,9","0,1"
575,Пензенская область,1995,12817,23427,-10610,"8,3","15,1","-6,8"
576,Пензенская область,2000,11172,25331,-14159,"7,5",17,"-9,5"
577,Пензенская область,2005,11827,25790,-13963,"8,4","18,2","-9,8"
578,Пензенская область,2006,12122,24023,-11901,"8,6","17,1","-8,5"
579,Пензенская область,2007,13472,22447,-8975,"9,7","16,1","-6,4"
580,Пензенская область,2008,14141,22547,-8406,"10,2","16,3","-6,1"
581,Пензенская область,2009,14212,21785,-7573,"10,3","15,8","-5,5"
582,Пензенская область,2010,14115,22064,-7949,"10,2","15,9","-5,7"
583,Самарская область,1970,42190,22766,19424,"15,2","8,2",7
584,Самарская область,1980,46468,31494,14974,"14,9","10,1","4,8"
585,Самарская область,1990,39918,35964,3954,"12,3","11,1","1,2"
586,Самарская область,1995,28409,48917,-20508,"8,6","14,8","-6,2"
587,Самарская область,2000,25791,53914,-28123,"7,9","16,4","-8,5"
588,Самарская область,2005,31148,51789,-20641,"9,7","16,2","-6,5"
589,Самарская область,2006,32058,49890,-17832,"10,1","15,7","-5,6"
590,Самарская область,2007,33949,48682,-14733,"10,7","15,3","-4,6"
591,Самарская область,2008,36314,48477,-12163,"11,4","15,3","-3,9"
592,Самарская область,2009,36309,47044,-10735,"11,5","14,8","-3,3"
593,Самарская область,2010,37231,48910,-11679,"11,6","15,2","-3,6"
594,Саратовская область,1970,34641,22168,12473,"14,1",9,"5,1"
595,Саратовская область,1980,37652,29500,8152,"14,6","11,5","3,1"
596,Саратовская область,1990,36249,31991,4258,"13,4","11,8","1,6"
597,Саратовская область,1995,24356,39841,-15485,"8,9","14,6","-5,7"
598,Саратовская область,2000,21979,44389,-22410,"8,1","16,4","-8,3"
599,Саратовская область,2005,23639,43944,-20305,9,"16,8","-7,8"
600,Саратовская область,2006,23781,40479,-16698,"9,1","15,6","-6,5"
601,Саратовская область,2007,26329,39641,-13312,"10,2","15,3","-5,1"
602,Саратовская область,2008,27384,39214,-11830,"10,6","15,2","-4,6"
603,Саратовская область,2009,27444,38532,-11088,"10,7",15,"-4,3"
604,Саратовская область,2010,27269,39610,-12341,"10,8","15,7","-4,9"
605,Ульяновская область,1970,17507,10784,6723,"14,2","8,8","5,4"
606,Ульяновская область,1980,19230,14092,5138,"15,1",11,"4,1"
607,Ульяновская область,1990,20013,15968,4045,"14,1","11,3","2,8"
608,Ульяновская область,1995,13288,20081,-6793,9,"13,6","-4,6"
609,Ульяновская область,2000,11547,22146,-10599,"8,1","15,6","-7,5"
610,Ульяновская область,2005,11595,22759,-11164,"8,6","16,9","-8,3"
611,Ульяновская область,2006,11585,21750,-10165,"8,7","16,4","-7,7"
612,Ульяновская область,2007,12251,20765,-8514,"9,3","15,8","-6,5"
613,Ульяновская область,2008,13461,19995,-6534,"10,3","15,3",-5
614,Ульяновская область,2009,13614,19423,-5809,"10,5","14,9","-4,4"
615,Ульяновская область,2010,13716,20403,-6687,"10,6","15,8","-5,2"
616,Курганская область,1970,16714,9829,6885,"15,4","9,1","6,3"
617,Курганская область,1980,18506,13250,5256,"17,1","12,2","4,9"
618,Курганская область,1990,16069,12644,3425,"14,5","11,4","3,1"
619,Курганская область,1995,10051,16305,-6254,"9,2","14,9","-5,7"
620,Курганская область,2000,10146,17207,-7061,"9,6","16,3","-6,7"
621,Курганская область,2005,10218,17399,-7181,"10,4","17,6","-7,2"
622,Курганская область,2006,10285,16003,-5718,"10,6","16,4","-5,8"
623,Курганская область,2007,11159,15334,-4175,"11,6","15,9","-4,3"
624,Курганская область,2008,11842,15501,-3659,"12,4","16,2","-3,8"
625,Курганская область,2009,11943,14889,-2946,"12,6","15,7","-3,1"
626,Курганская область,2010,11816,14626,-2810,13,16,-3
627,Свердловская область,1970,62574,36118,26456,"14,5","8,4","6,1"
628,Свердловская область,1980,72174,50942,21232,"16,1","11,4","4,7"
629,Свердловская область,1990,57686,52978,4708,"12,1","11,1",1
630,Свердловская область,1995,40003,73048,-33045,"8,6","15,6",-7
631,Свердловская область,2000,38372,75579,-37207,"8,4","16,6","-8,2"
632,Свердловская область,2005,45956,73423,-27467,"10,4","16,6","-6,2"
633,Свердловская область,2006,47328,67249,-19921,"10,7","15,3","-4,6"
634,Свердловская область,2007,50638,64444,-13806,"11,5","14,7","-3,2"
635,Свердловская область,2008,54364,64702,-10338,"12,4","14,7","-2,3"
636,Свердловская область,2009,56323,63045,-6722,"12,8","14,3","-1,5"
637,Свердловская область,2010,57540,61486,-3946,"13,4","14,3","-0,9"
638,Тюменская область,1970,25039,12162,12877,"17,7","8,6","9,1"
639,Тюменская область,1980,38775,18166,20609,"19,4","9,1","10,3"
640,Тюменская область,1990,50094,19944,30150,"15,9","6,3","9,6"
641,Тюменская область,1995,33479,31101,2378,"10,6","9,8","0,8"
642,Тюменская область,2000,34250,30159,4091,"10,6","9,3","1,3"
643,Тюменская область,2005,43094,32550,10544,13,"9,8","3,2"
644,Тюменская область,2006,44049,30861,13188,"13,2","9,3","3,9"
645,Тюменская область,2007,48028,30332,17696,"14,3",9,"5,3"
646,Тюменская область,2008,51043,30672,20371,"15,1","9,1",6
647,Тюменская область,2009,52992,30139,22853,"15,5","8,8","6,7"
648,Тюменская область,2010,54521,30502,24019,"16,1",9,"7,1"
649,Ханты-Мансийский автономный округ - Югра,1970,5959,2025,3934,"21,3","7,2","14,1"
650,Ханты-Мансийский автономный округ - Югра,1980,13901,4116,9785,"21,4","6,3","15,1"
651,Ханты-Мансийский автономный округ - Югра,1990,21812,5354,16458,"17,1","4,2","12,9"
652,Ханты-Мансийский автономный округ - Югра,1995,14418,10041,4377,"11,1","7,7","3,4"
653,Ханты-Мансийский автономный округ - Югра,2000,15579,9426,6153,"11,4","6,9","4,5"
654,Ханты-Мансийский автономный округ - Югра,2005,19958,10415,9543,"13,5","7,1","6,4"
655,Ханты-Мансийский автономный округ - Югра,2006,20366,10077,10289,"13,7","6,8","6,9"
656,Ханты-Мансийский автономный округ - Югра,2007,21887,10093,11794,"14,6","6,7","7,9"
657,Ханты-Мансийский автономный округ - Югра,2008,23197,10215,12982,"15,3","6,8","8,5"
658,Ханты-Мансийский автономный округ - Югра,2009,23840,10107,13733,"15,6","6,6",9
659,Ханты-Мансийский автономный округ - Югра,2010,25089,10447,14642,"16,4","6,8","9,6"
660,Ямало-Ненецкий автономный округ,1970,1683,879,804,"20,4","10,7","9,7"
661,Ямало-Ненецкий автономный округ,1980,3347,1178,2169,"17,6","6,2","11,4"
662,Ямало-Ненецкий автономный округ,1990,8032,1631,6401,"16,4","3,3","13,1"
663,Ямало-Ненецкий автономный округ,1995,6337,3107,3230,"13,1","6,4","6,7"
664,Ямало-Ненецкий автономный округ,2000,5839,2763,3076,"11,7","5,6","6,1"
665,Ямало-Ненецкий автономный округ,2005,7148,3099,4049,"13,6","5,9","7,7"
666,Ямало-Ненецкий автономный округ,2006,7036,3000,4036,"13,2","5,6","7,6"
667,Ямало-Ненецкий автономный округ,2007,7700,2937,4763,"14,2","5,4","8,8"
668,Ямало-Ненецкий автономный округ,2008,7892,2959,4933,"14,5","5,4","9,1"
669,Ямало-Ненецкий автономный округ,2009,8216,2924,5292,"15,1","5,4","9,7"
670,Ямало-Ненецкий автономный округ,2010,8263,2873,5390,"15,8","5,5","10,3"
671,Челябинская область,1970,50776,25946,24830,"15,4","7,9","7,5"
672,Челябинская область,1980,56234,34984,21250,"16,2","10,1","6,1"
673,Челябинская область,1990,48599,38367,10232,"13,1","10,4","2,7"
674,Челябинская область,1995,33161,54730,-21569,9,"14,9","-5,9"
675,Челябинская область,2000,32355,56444,-24089,"8,9","15,5","-6,6"
676,Челябинская область,2005,36770,57753,-20983,"10,4","16,3","-5,9"
677,Челябинская область,2006,37923,54263,-16340,"10,8","15,4","-4,6"
678,Челябинская область,2007,41289,52282,-10993,"11,8","14,9","-3,1"
679,Челябинская область,2008,44931,52625,-7694,"12,8",15,"-2,2"
680,Челябинская область,2009,45550,50034,-4484,13,"14,3","-1,3"
681,Челябинская область,2010,46612,50084,-3472,"13,4","14,4",-1
682,Алтай,1970,3236,1486,1750,"19,3","8,9","10,4"
683,Алтай,1980,3841,2082,1759,"21,8","11,8",10
684,Алтай,1990,3753,2126,1627,"19,3","10,9","8,4"
685,Алтай,1995,2853,2637,216,"14,3","13,2","1,1"
686,Алтай,2000,2907,2645,262,"14,3",13,"1,3"
687,Алтай,2005,3502,3170,332,"17,2","15,5","1,7"
688,Алтай,2006,3395,2837,558,"16,6","13,8","2,8"
689,Алтай,2007,4066,2574,1492,"19,7","12,5","7,2"
690,Алтай,2008,4442,2549,1893,"21,3","12,2","9,1"
691,Алтай,2009,4266,2492,1774,"20,3","11,9","8,4"
692,Алтай,2010,4224,2508,1716,"20,5","12,2","8,3"
693,Бурятия,1970,14766,6301,8465,"18,1","7,7","10,4"
694,Бурятия,1980,19859,8734,11125,"21,6","9,5","12,1"
695,Бурятия,1990,19185,9602,9583,"18,3","9,1","9,2"
696,Бурятия,1995,12311,12588,-277,"11,9","12,2","-0,3"
697,Бурятия,2000,11654,13155,-1501,"11,6","13,1","-1,5"
698,Бурятия,2005,13551,15144,-1593,14,"15,7","-1,7"
699,Бурятия,2006,14193,13930,263,"14,8","14,5","0,3"
700,Бурятия,2007,15460,12802,2658,"16,1","13,3","2,8"
701,Бурятия,2008,16372,12948,3424,17,"13,5","3,5"
702,Бурятия,2009,16729,12466,4263,"17,4",13,"4,4"
703,Бурятия,2010,16506,12361,4145,17,"12,7","4,3"
704,Тыва,1970,6559,1938,4621,"28,2","8,3","19,9"
705,Тыва,1980,7133,2748,4385,"26,6","10,2","16,4"
706,Тыва,1990,8116,2664,5452,"26,3","8,6","17,7"
707,Тыва,1995,6172,4010,2162,"20,3","13,2","7,1"
708,Тыва,2000,4871,4170,701,"15,9","13,6","2,3"
709,Тыва,2005,5979,4326,1653,"19,4",14,"5,4"
710,Тыва,2006,5950,3802,2148,"19,3","12,3",7
711,Тыва,2007,7568,3687,3881,"24,4","11,9","12,5"
712,Тыва,2008,7874,3526,4348,"25,2","11,3","13,9"
713,Тыва,2009,8242,3666,4576,"26,1","11,6","14,5"
714,Тыва,2010,8262,3566,4696,"26,9","11,6","15,3"
715,Республика Хакасия,1970,7347,3749,3598,"16,5","8,4","8,1"
716,Республика Хакасия,1980,9994,5345,4649,"19,8","10,6","9,2"
717,Республика Хакасия,1990,8724,6060,2664,"15,3","10,6","4,7"
718,Республика Хакасия,1995,5807,8186,-2379,"10,2","14,3","-4,1"
719,Республика Хакасия,2000,5634,8104,-2470,"10,1","14,6","-4,5"
720,Республика Хакасия,2005,6198,9411,-3213,"11,5","17,4","-5,9"
721,Республика Хакасия,2006,6465,7927,-1462,12,"14,8","-2,8"
722,Республика Хакасия,2007,7384,7324,60,"13,8","13,6","0,2"
723,Республика Хакасия,2008,7935,7427,508,"14,8","13,8",1
724,Республика Хакасия,2009,8062,7255,807,15,"13,5","1,5"
725,Республика Хакасия,2010,8014,7373,641,"15,1","13,9","1,2"
726,Алтайский край,1970,37471,20991,16480,15,"8,4","6,6"
727,Алтайский край,1980,44279,27657,16622,"17,6",11,"6,6"
728,Алтайский край,1990,34176,29329,4847,"12,9","11,1","1,8"
729,Алтайский край,1995,23338,39551,-16213,"8,7","14,7",-6
730,Алтайский край,2000,24674,37813,-13139,"9,3","14,3",-5
731,Алтайский край,2005,26395,42571,-16176,"10,3","16,7","-6,4"
732,Алтайский край,2006,25594,38558,-12964,"10,1","15,2","-5,1"
733,Алтайский край,2007,28363,37402,-9039,"11,3","14,9","-3,6"
734,Алтайский край,2008,30741,37497,-6756,"12,3",15,"-2,7"
735,Алтайский край,2009,30906,35774,-4868,"12,4","14,3","-1,9"
736,Алтайский край,2010,30853,36369,-5516,"12,7",15,"-2,3"
737,Забайкальский край,1970,20656,8448,12208,18,"7,4","10,6"
738,Забайкальский край,1980,26534,11798,14736,"21,3","9,5","11,8"
739,Забайкальский край,1990,23233,12072,11161,"17,6","9,2","8,4"
740,Забайкальский край,1995,15858,16638,-780,"12,7","13,3","-0,6"
741,Забайкальский край,2000,13937,17138,-3201,"11,8","14,5","-2,7"
742,Забайкальский край,2005,15327,19521,-4194,"13,5","17,2","-3,7"
743,Забайкальский край,2006,15613,17433,-1820,"13,9","15,5","-1,6"
744,Забайкальский край,2007,16652,16186,466,"14,9","14,4","0,5"
745,Забайкальский край,2008,17738,16018,1720,"15,9","14,3","1,6"
746,Забайкальский край,2009,17816,15255,2561,"15,9","13,7","2,2"
747,Забайкальский край,2010,17577,15331,2246,"15,9","13,8","2,1"
748,Красноярский край,1970,41203,19435,21768,"16,4","7,7","8,7"
749,Красноярский край,1980,49550,26043,23507,"18,1","9,5","8,6"
750,Красноярский край,1990,43640,29268,14372,"13,8","9,3","4,5"
751,Красноярский край,1995,30596,43406,-12810,"9,8",14,"-4,2"
752,Красноярский край,2000,28111,44456,-16345,"9,3","14,8","-5,5"
753,Красноярский край,2005,31534,45723,-14189,"10,8","15,7","-4,9"
754,Красноярский край,2006,31836,40401,-8565,11,"13,9","-2,9"
755,Красноярский край,2007,34206,38470,-4264,"11,8","13,3","-1,5"
756,Красноярский край,2008,36880,38987,-2107,"12,8","13,5","-0,7"
757,Красноярский край,2009,38150,37635,515,"13,2",13,"0,2"
758,Красноярский край,2010,38527,38131,396,"13,6","13,5","0,1"
759,Иркутская область,1970,40460,17567,22893,"17,4","7,6","9,8"
760,Иркутская область,1980,50966,25996,24970,"19,6",10,"9,6"
761,Иркутская область,1990,45202,27855,17347,"16,2",10,"6,2"
762,Иркутская область,1995,29769,40937,-11168,"10,9",15,"-4,1"
763,Иркутская область,2000,28062,40829,-12767,"10,7","15,5","-4,8"
764,Иркутская область,2005,30266,43202,-12936,"11,9",17,"-5,1"
765,Иркутская область,2006,31039,38159,-7120,"12,3","15,1","-2,8"
766,Иркутская область,2007,34711,35157,-446,"13,8",14,"-0,2"
767,Иркутская область,2008,37548,35359,2189,15,"14,1","0,9"
768,Иркутская область,2009,38073,34898,3175,"15,2","13,9","1,3"
769,Иркутская область,2010,36935,35105,1830,"15,2","14,4","0,8"
770,Кемеровская область,1970,41636,22994,18642,"14,3","7,9","6,4"
771,Кемеровская область,1980,49890,32653,17237,"16,8",11,"5,8"
772,Кемеровская область,1990,40066,35082,4984,"12,9","11,3","1,6"
773,Кемеровская область,1995,27314,51011,-23697,"8,9","16,7","-7,8"
774,Кемеровская область,2000,26580,49176,-22596,9,"16,7","-7,7"
775,Кемеровская область,2005,30862,53152,-22290,"10,8","18,7","-7,9"
776,Кемеровская область,2006,32060,48870,-16810,"11,3","17,3",-6
777,Кемеровская область,2007,34242,46816,-12574,"12,1","16,6","-4,5"
778,Кемеровская область,2008,36675,46121,-9446,13,"16,3","-3,3"
779,Кемеровская область,2009,37599,44856,-7257,"13,3","15,9","-2,6"
780,Кемеровская область,2010,36370,44522,-8152,"13,2","16,1","-2,9"
781,Новосибирская область,1970,35729,19836,15893,"14,3","7,9","6,4"
782,Новосибирская область,1980,45238,27678,17560,"17,1","10,5","6,6"
783,Новосибирская область,1990,36116,29558,6558,"13,2","10,8","2,4"
784,Новосибирская область,1995,23486,38756,-15270,"8,6","14,2","-5,6"
785,Новосибирская область,2000,23138,38522,-15384,"8,5","14,2","-5,7"
786,Новосибирская область,2005,28269,42719,-14450,"10,6","16,1","-5,5"
787,Новосибирская область,2006,27906,40241,-12335,"10,5","15,2","-4,7"
788,Новосибирская область,2007,30136,38818,-8682,"11,4","14,7","-3,3"
789,Новосибирская область,2008,33056,38329,-5273,"12,5","14,5",-2
790,Новосибирская область,2009,34249,37203,-2954,"12,9","14,1","-1,2"
791,Новосибирская область,2010,35073,37055,-1982,"13,2","13,9","-0,7"
792,Омская область,1970,29012,14105,14907,"15,9","7,7","8,2"
793,Омская область,1980,37800,19507,18293,"19,2","9,9","9,3"
794,Омская область,1990,32191,20110,12081,"14,9","9,3","5,6"
795,Омская область,1995,22313,26747,-4434,"10,3","12,4","-2,1"
796,Омская область,2000,18363,28713,-10350,"8,6","13,5","-4,9"
797,Омская область,2005,21282,31686,-10404,"10,4","15,5","-5,1"
798,Омская область,2006,21424,30159,-8735,"10,6","14,9","-4,3"
799,Омская область,2007,23715,29609,-5894,"11,7","14,6","-2,9"
800,Омская область,2008,25050,28819,-3769,"12,4","14,3","-1,9"
801,Омская область,2009,25639,27342,-1703,"12,7","13,6","-0,9"
802,Омская область,2010,26203,27504,-1301,"13,2","13,9","-0,7"
803,Томская область,1970,12343,6230,6113,"15,6","7,9","7,7"
804,Томская область,1980,16056,8622,7434,"18,2","9,8","8,4"
805,Томская область,1990,13550,9402,4148,"12,6","8,7","3,9"
806,Томская область,1995,9853,13969,-4116,"9,2",13,"-3,8"
807,Томская область,2000,10071,13960,-3889,"9,5","13,2","-3,7"
808,Томская область,2005,11107,15025,-3918,"10,7","14,5","-3,8"
809,Томская область,2006,11486,13913,-2427,"11,1","13,5","-2,4"
810,Томская область,2007,12429,13253,-824,12,"12,8","-0,8"
811,Томская область,2008,13308,13353,-45,"12,8","12,9","-0,1"
812,Томская область,2009,13738,13406,332,"13,2","12,9","0,3"
813,Томская область,2010,13627,13197,430,"13,1","12,6","0,5"
814,Республика Саха (Якутия),1970,13899,5700,8199,"20,8","8,5","12,3"
815,Республика Саха (Якутия),1980,18132,7501,10631,"20,8","8,6","12,2"
816,Республика Саха (Якутия),1990,21662,7470,14192,"19,4","6,7","12,7"
817,Республика Саха (Якутия),1995,15731,10079,5652,"15,3","9,8","5,5"
818,Республика Саха (Якутия),2000,13147,9325,3822,"13,7","9,7",4
819,Республика Саха (Якутия),2005,13591,9696,3895,"14,3","10,2","4,1"
820,Республика Саха (Якутия),2006,13713,9245,4468,"14,4","9,7","4,7"
821,Республика Саха (Якутия),2007,15268,9179,6089,"16,1","9,7","6,4"
822,Республика Саха (Якутия),2008,15363,9579,5784,"16,2","10,1","6,1"
823,Республика Саха (Якутия),2009,15970,9353,6617,"16,8","9,8",7
824,Республика Саха (Якутия),2010,16109,9402,6707,"16,8","9,8",7
825,Камчатский край,1970,5108,1970,3138,"17,5","6,7","10,8"
826,Камчатский край,1980,6517,2709,3808,"16,8",7,"9,8"
827,Камчатский край,1990,5905,2966,2939,"12,4","6,2","6,2"
828,Камчатский край,1995,3806,4656,-850,"9,2","11,2",-2
829,Камчатский край,2000,3426,4047,-621,"9,3",11,"-1,7"
830,Камчатский край,2005,3868,4405,-537,11,"12,6","-1,6"
831,Камчатский край,2006,3842,3943,-101,11,"11,3","-0,3"
832,Камчатский край,2007,3931,3863,68,"11,3","11,2","0,1"
833,Камчатский край,2008,4022,3926,96,"11,7","11,4","0,3"
834,Камчатский край,2009,4074,4045,29,"11,9","11,8","0,1"
835,Камчатский край,2010,3880,4067,-187,"12,1","12,6","-0,5"
836,Приморский край,1970,30648,12322,18326,"17,7","7,1","10,6"
837,Приморский край,1980,35950,18583,17367,18,"9,3","8,7"
838,Приморский край,1990,33614,20874,12740,"14,6","9,1","5,5"
839,Приморский край,1995,21235,29550,-8315,"9,4","13,1","-3,7"
840,Приморский край,2000,18393,29513,-11120,"8,6","13,9","-5,3"
841,Приморский край,2005,21174,32812,-11638,"10,4","16,2","-5,8"
842,Приморский край,2006,20935,30052,-9117,"10,4","14,9","-4,5"
843,Приморский край,2007,22455,29120,-6665,"11,2","14,6","-3,4"
844,Приморский край,2008,22602,28944,-6342,"11,3","14,5","-3,2"
845,Приморский край,2009,23469,27458,-3989,"11,8","13,8",-2
846,Приморский край,2010,23164,27974,-4810,"11,8","14,3","-2,5"
847,Хабаровский край,1970,20151,8267,11884,"17,1",7,"10,1"
848,Хабаровский край,1980,26256,12757,13499,"18,7","9,1","9,6"
849,Хабаровский край,1990,24482,14991,9491,"15,1","9,2","5,9"
850,Хабаровский край,1995,14625,20668,-6043,"9,4","13,3","-3,9"
851,Хабаровский край,2000,12400,20745,-8345,"8,5","14,1","-5,6"
852,Хабаровский край,2005,15410,23074,-7664,"10,9","16,3","-5,4"
853,Хабаровский край,2006,15558,20958,-5400,11,"14,9","-3,9"
854,Хабаровский край,2007,16303,19947,-3644,"11,6","14,2","-2,6"
855,Хабаровский край,2008,17067,19570,-2503,"12,2",14,"-1,8"
856,Хабаровский край,2009,17573,19115,-1542,"12,5","13,6","-1,1"
857,Хабаровский край,2010,17407,19611,-2204,"12,9","14,6","-1,7"
858,Амурская область,1970,14350,6058,8292,18,"7,6","10,4"
859,Амурская область,1980,18735,9261,9474,"19,7","9,7",10
860,Амурская область,1990,17087,9051,8036,"16,2","8,6","7,6"
861,Амурская область,1995,10533,12431,-1898,"10,6","12,5","-1,9"
862,Амурская область,2000,9433,13532,-4099,"10,2","14,6","-4,4"
863,Амурская область,2005,10659,14959,-4300,"12,1","16,9","-4,8"
864,Амурская область,2006,10391,13635,-3244,"11,8","15,5","-3,7"
865,Амурская область,2007,10956,12479,-1523,"12,6","14,3","-1,7"
866,Амурская область,2008,11218,13099,-1881,"12,9","15,1","-2,2"
867,Амурская область,2009,11397,12629,-1232,"13,2","14,6","-1,4"
868,Амурская область,2010,11479,12740,-1261,"13,8","15,3","-1,5"
869,Магаданская область,1970,4170,1423,2747,"16,3","5,6","10,7"
870,Магаданская область,1980,5804,2205,3599,"16,9","6,4","10,5"
871,Магаданская область,1990,5282,2179,3103,"13,6","5,6",8
872,Магаданская область,1995,2234,2927,-693,"8,8","11,5","-2,7"
873,Магаданская область,2000,1925,2345,-420,"9,7","11,8","-2,1"
874,Магаданская область,2005,1908,2357,-449,11,"13,6","-2,6"
875,Магаданская область,2006,1820,2242,-422,"10,7","13,2","-2,5"
876,Магаданская область,2007,1825,2205,-380,"10,9","13,2","-2,3"
877,Магаданская область,2008,1786,2263,-477,"10,9","13,8","-2,9"
878,Магаданская область,2009,1960,2164,-204,"12,1","13,3","-1,2"
879,Магаданская область,2010,1807,2052,-245,"11,5",13,"-1,5"
880,Сахалинская область,1970,10485,4167,6318,17,"6,8","10,2"
881,Сахалинская область,1980,11332,5931,5401,"17,1",9,"8,1"
882,Сахалинская область,1990,10114,5811,4303,"14,2","8,1","6,1"
883,Сахалинская область,1995,5873,11238,-5365,"9,1","17,4","-8,3"
884,Сахалинская область,2000,5210,7547,-2337,"9,2","13,4","-4,2"
885,Сахалинская область,2005,6010,9212,-3202,"11,4","17,4",-6
886,Сахалинская область,2006,5860,7862,-2002,"11,2",15,"-3,8"
887,Сахалинская область,2007,6123,7364,-1241,"11,8","14,2","-2,4"
888,Сахалинская область,2008,6344,7470,-1126,"12,3","14,5","-2,2"
889,Сахалинская область,2009,6196,7419,-1223,"12,1","14,5","-2,4"
890,Сахалинская область,2010,6016,7422,-1406,"12,1","14,9","-2,8"
891,Еврейская автономная область,1970,3248,1341,1907,"18,7","7,7",11
892,Еврейская автономная область,1980,3976,1890,2086,"20,8","9,9","10,9"
893,Еврейская автономная область,1990,3897,2091,1806,"17,8","9,6","8,2"
894,Еврейская автономная область,1995,2308,2868,-560,"11,1","13,8","-2,7"
895,Еврейская автономная область,2000,1883,2817,-934,"9,7","14,5","-4,8"
896,Еврейская автономная область,2005,2172,3365,-1193,"11,6","17,9","-6,3"
897,Еврейская автономная область,2006,2260,2978,-718,"12,1",16,"-3,9"
898,Еврейская автономная область,2007,2418,2794,-376,13,"15,1","-2,1"
899,Еврейская автономная область,2008,2587,2838,-251,"13,9","15,3","-1,4"
900,Еврейская автономная область,2009,2438,2739,-301,"13,2","14,8","-1,6"
901,Еврейская автономная область,2010,2408,2736,-328,"13,6","15,5","-1,9"
902,Чукотский автономный округ,1970,1751,599,1152,"16,9","5,8","11,1"
903,Чукотский автономный округ,1980,2208,653,1555,"16,1","4,7","11,4"
904,Чукотский автономный округ,1990,2208,598,1610,"13,8","3,7","10,1"
905,Чукотский автономный округ,1995,935,816,119,"10,4","9,1","1,3"
906,Чукотский автономный округ,2000,686,570,116,"11,5","9,6","1,9"
907,Чукотский автономный округ,2005,795,597,198,"15,7","11,8","3,9"
908,Чукотский автономный округ,2006,771,585,186,"15,3","11,6","3,7"
909,Чукотский автономный округ,2007,801,595,206,"15,9","11,8","4,1"
910,Чукотский автономный округ,2008,751,620,131,"15,1","12,4","2,7"
911,Чукотский автономный округ,2009,695,640,55,"14,2",13,"1,2"
912,Чукотский автономный округ,2010,746,698,48,"14,7","13,8","0,9"
